{
  "plan": {
    "tiles":
      [["0", "0", "0", "0", "0", "0", "0", "0", "0", "0", "0", "0"],
       ["0", "0", "0", "0", "0", "0", "0", "0", "0", "0", "0", "0"],
       ["0", "0", "1", "B", "c", "1", "1", "1", "b", "b", "0", "0"],
       ["0", "0", "1", "1", "1", "1", "1", "1", "1", "1", "0", "0"],
       ["0", "0", "c", "1", "1", "1", "1", "1", "1", "c", "0", "0"],
       ["0", "0", "B", "1", "1", "1", "1", "1", "1", "c", "0", "0"],
       ["0", "0", "b", "1", "1", "1", "1", "1", "1", "B", "0", "0"],
       ["0", "0", "b", "1", "c", "1", "1", "1", "1", "B", "0", "0"],
       ["0", "0", "1", "1", "1", "1", "1", "c", "c", "1", "0", "0"],  
       ["0", "0", "0", "0", "0", "1", "0", "0", "0", "0", "0", "0"],
       ["0", "0", "0", "0", "0", "1", "0", "0", "0", "0", "0", "0"],
       ["0", "0", "0", "0", "0", "1", "0", "0", "0", "0", "0", "0"],
       ["0", "0", "0", "1", "1", "1", "1", "1", "0", "0", "0", "0"],
       ["0", "0", "0", "1", "B", "1", "1", "1", "0", "0", "0", "0"],
       ["0", "0", "0", "1", "1", "1", "0", "1", "0", "0", "0", "0"],
       ["0", "0", "0", "1", "1", "1", "0", "1", "0", "0", "0", "0"],
       ["0", "0", "0", "0", "0", "0", "0", "0", "0", "0", "0", "0"],
       ["0", "0", "0", "0", "0", "0", "0", "0", "0", "0", "0", "0"]]
  }
}